Well,Barcode,BarCounter_1st,BarCounter_2nd,CITE_1st,CITE_2nd,Change_1st,Change_2nd,Prop_Change_1st,Prop_change_2nd,Ratio_1st:2nd
Pool-16,CCTTCAGCAGGCTCTG,141,89,143,90,-2,-1,-0.014184397163120567,-0.011235955056179775,1.5842696629213484
Pool-16,GAGACTTCAAATGGAT,1740,142,1679,141,61,1,0.03505747126436782,0.007042253521126761,12.253521126760564
Pool-24,GCTGGGTAGTCCCTAA,1258,66,1217,65,41,1,0.03259141494435612,0.015151515151515152,19.060606060606062
Pool-32,AAGACAACAATAGTAG,418,103,407,97,11,6,0.02631578947368421,0.05825242718446602,4.058252427184466
Pool-32,CGGGTCAAGATGCTAA,678,192,666,192,12,0,0.017699115044247787,0.0,3.53125
Pool-32,CTACAGACAGACACCC,1686,98,1587,102,99,-4,0.05871886120996441,-0.04081632653061224,17.20408163265306
Pool-32,GAAGGACTCGAAGCCC,1267,97,1202,96,65,1,0.05130228887134965,0.010309278350515464,13.061855670103093
Pool-32,GTGTGATGTACGCTAT,683,119,655,116,28,3,0.040995607613469986,0.025210084033613446,5.739495798319328
Pool-32,GTTCCGTAGACCATAA,872,201,821,191,51,10,0.058486238532110095,0.04975124378109453,4.338308457711443
Pool-32,GTTGTGAGTCGTCAGC,535,194,518,196,17,-2,0.03177570093457944,-0.010309278350515464,2.7577319587628866
Pool-32,TATCCTATCCTGTTAT,801,78,776,78,25,0,0.031210986267166042,0.0,10.26923076923077
Pool-32,TATGTTCTCGGAGTGA,724,199,684,194,40,5,0.055248618784530384,0.02512562814070352,3.6381909547738696
Pool-32,TGCGACGGTTCTCTAT,639,193,608,194,31,-1,0.048513302034428794,-0.0051813471502590676,3.3108808290155443
Pool-48,AAGCCATCATAAGCAA,2060,97,1936,95,124,2,0.06019417475728155,0.020618556701030927,21.237113402061855
Pool-48,AATCACGTCACGGAGA,1449,95,1362,93,87,2,0.060041407867494824,0.021052631578947368,15.25263157894737
Pool-48,ACCAACAAGGTACTGG,812,232,778,229,34,3,0.04187192118226601,0.01293103448275862,3.5
Pool-48,CACATGACACTACCGG,772,280,736,274,36,6,0.046632124352331605,0.02142857142857143,2.757142857142857
Pool-48,GCGGATCTCATCGCAA,686,96,657,93,29,3,0.04227405247813411,0.03125,7.145833333333333
Pool-48,GGGCTACAGGTGCATG,1045,277,1022,275,23,2,0.02200956937799043,0.007220216606498195,3.7725631768953067
Pool-48,GGGTCTGTCACATCAG,2719,96,2532,97,187,-1,0.0687752850312615,-0.010416666666666666,28.322916666666668
Pool-48,GTCACTCCAGATCACT,2627,273,2432,269,195,4,0.07422915873620099,0.014652014652014652,9.622710622710622
Pool-64,AACCTTTAGTCACAGG,1680,196,1598,196,82,0,0.04880952380952381,0.0,8.571428571428571
Pool-64,AGAGAGCCAACCTATG,235,136,235,133,0,3,0.0,0.022058823529411766,1.7279411764705883
Pool-64,AGGAGGTCACAGTCCG,407,320,403,323,4,-3,0.009828009828009828,-0.009375,1.271875
Pool-64,ATGCCTCTCCAACCAA,683,198,666,198,17,0,0.024890190336749635,0.0,3.4494949494949494
Pool-64,CACAGATCAATAGTAG,952,137,921,133,31,4,0.032563025210084036,0.029197080291970802,6.9489051094890515
Pool-64,CACAGGCCATTCCTAT,960,137,934,135,26,2,0.027083333333333334,0.014598540145985401,7.007299270072993
Pool-64,CGATGCGGTAGTCACT,2224,384,2049,380,175,4,0.07868705035971223,0.010416666666666666,5.791666666666667
Pool-64,CTATAGGCAGAAACCG,1340,322,1293,315,47,7,0.03507462686567164,0.021739130434782608,4.161490683229814
Pool-64,CTCAACCGTCATCAGT,372,367,370,353,2,14,0.005376344086021506,0.03814713896457766,1.013623978201635
Pool-64,GCTCAAACAGTCGGTC,2414,197,2286,196,128,1,0.05302402651201325,0.005076142131979695,12.253807106598984
Pool-64,GGAGGATTCCGATAGT,831,135,805,132,26,3,0.031287605294825514,0.022222222222222223,6.155555555555556
Pool-64,GTCGAATAGCTGTCCG,375,293,366,287,9,6,0.024,0.020477815699658702,1.2798634812286689
Pool-64,GTGGCGTGTCGTGTTA,647,382,636,372,11,10,0.017001545595054096,0.02617801047120419,1.693717277486911
Pool-64,TAACGACTCTGCATAG,2773,195,2558,197,215,-2,0.07753335737468446,-0.010256410256410256,14.22051282051282
Pool-64,TATTGGGGTCATCCCT,1151,383,1113,376,38,7,0.03301476976542137,0.018276762402088774,3.0052219321148823
Pool-64,TCCGGGATCAGTCAGT,2448,136,2287,135,161,1,0.06576797385620915,0.007352941176470588,18.0
Pool-80,ACAACCAGTGCGGATA,1903,169,1800,171,103,-2,0.054125065685759324,-0.011834319526627219,11.2603550295858
Pool-80,ACCTGTCAGTTTCGAC,1513,144,1449,238,64,-94,0.04230006609385327,-0.6527777777777778,10.506944444444445
Pool-80,AGGGCCTTCTTTGCTA,665,450,656,441,9,9,0.013533834586466165,0.02,1.4777777777777779
Pool-80,AGTTCCCCATAATGCC,987,399,955,402,32,-3,0.03242147922998987,-0.007518796992481203,2.473684210526316
Pool-80,ATTCCTAGTAGGATAT,1280,449,1233,442,47,7,0.03671875,0.015590200445434299,2.8507795100222717
Pool-80,CATCGGGCAGGATCTT,764,327,738,326,26,1,0.034031413612565446,0.0030581039755351682,2.3363914373088686
Pool-80,CCTGTTGTCCCTCATG,1286,133,1224,133,62,0,0.04821150855365474,0.0,9.669172932330827
Pool-80,GATCCCTGTTCGTTCC,832,452,819,445,13,7,0.015625,0.015486725663716814,1.8407079646017699
Pool-80,GGAATGGAGCCTGAGA,638,327,619,324,19,3,0.029780564263322883,0.009174311926605505,1.9510703363914372
Pool-80,GGAGGTATCAGCGCGT,852,405,833,402,19,3,0.022300469483568074,0.007407407407407408,2.1037037037037036
Pool-80,GGGTAGATCCAGTTCC,1057,244,1024,243,33,1,0.03122043519394513,0.004098360655737705,4.331967213114754
Pool-80,GGGTATTCAGCTTCGG,499,447,492,441,7,6,0.014028056112224449,0.013422818791946308,1.116331096196868
Pool-80,GGGTCTGCATACTGTG,1028,450,995,451,33,-1,0.032101167315175094,-0.0022222222222222222,2.2844444444444445
Pool-80,GTACAACAGTGCTCGC,564,237,553,241,11,-4,0.01950354609929078,-0.016877637130801686,2.3797468354430378
Pool-80,GTAGATCTCATGACAC,1956,407,1844,407,112,0,0.05725971370143149,0.0,4.805896805896806
Pool-80,GTGGTTATCGCGTAGC,1118,133,1079,131,39,2,0.03488372093023256,0.015037593984962405,8.406015037593985
Pool-80,GTTTGGAGTAGAGACC,1151,133,1112,133,39,0,0.03388357949609035,0.0,8.654135338345865
Pool-80,TGACGCGGTATCGTAC,803,455,782,450,21,5,0.026151930261519303,0.01098901098901099,1.7648351648351648
Pool-80,TGCTTGCGTGTCATGT,1274,442,1241,442,33,0,0.025902668759811617,0.0,2.8823529411764706
Pool-80,TTAATCCCAGCGAACA,3210,243,2885,241,325,2,0.10124610591900311,0.00823045267489712,13.209876543209877
Pool-80,TTCATGTAGCCATTCA,765,452,747,445,18,7,0.023529411764705882,0.015486725663716814,1.6924778761061947
Pool-80,TTCATTGTCTATCACT,947,448,912,441,35,7,0.03695881731784583,0.015625,2.1138392857142856
Pool-80,TTCCTTCGTAAGATCA,822,398,803,397,19,1,0.023114355231143552,0.002512562814070352,2.0653266331658293
